+---+---+---+---+---+---+---+---+---+---+
|   |           |                       |
+   +   +---+   +---+---+   +---+---+   +
|   |   |       |       |   |       |   |
+   +---+   +---+   +   +---+   +---+   +
|           |       |       |       |   |
+---+---+   +   +---+---+   +---+   +   +
|           |   |       |   |   |       |
+   +---+---+   +   +   +   +   +---+---+
|   |           |   |       |           |
+   +   +---+---+   +---+---+---+---+   +
|   |   |           |                   |
+   +---+   +---+---+   +---+---+---+   +
|           |       |   |   |           |
+---+---+   +   +   +---+   +   +---+   +
|       |   |   |           |       |   |
+   +   +---+   +---+---+---+---+   +   +
|   |               |           |   |   |
+   +---+---+---+   +   +---+   +   +   +
|                   |   |           |   |
+---+---+---+---+---+---+---+---+---+---+
